4 4
8 6
6
0 0
14 0
14 14
0 14
10 11
5 14

0 0 0 0 1 0 1 1 1 0 0 0 0 0 0
0 1 1 0 1 0 0 0 1 0 1 0 0 1 0
0 0 0 0 1 0 1 0 1 0 1 0 1 1 0 
0 0 1 0 1 0 1 0 0 0 1 0 1 0 0
0 1 1 0 0 0 1 1 1 0 0 0 0 0 1
0 0 1 1 1 0 1 0 0 0 0 1 1 1 0
1 0 0 0 0 0 1 0 0 1 0 0 0 0 0 
1 1 1 0 1 0 0 0 1 1 1 0 1 0 0
0 0 1 0 1 1 1 0 0 0 0 0 1 1 0
1 0 0 0 0 0 0 0 0 1 0 0 0 1 0
1 1 1 1 1 0 0 1 0 1 1 1 0 1 0
1 0 0 0 1 0 0 1 0 0 0 1 0 0 0
0 0 1 0 0 0 1 1 1 0 1 1 0 0 1
0 1 1 0 1 0 0 0 0 0 1 0 0 1 1
0 0 0 0 1 0 0 1 0 0 0 0 0 0 0