4 4
10 6
6
0 0
13 0
0 14
14 14
4 11
8 0
0 0 0 0 0 0 0 0 0 0 0 0 0 0 1
0 1 0 1 1 1 1 1 1 1 1 0 1 0 0
0 1 0 0 0 0 0 0 0 0 0 0 1 0 1
0 1 0 1 1 1 0 1 0 0 0 1 1 0 0
0 1 0 1 0 1 0 0 0 1 0 1 0 1 0
0 1 0 1 0 1 1 1 0 1 0 1 0 0 0 
0 1 0 1 0 0 0 0 0 1 0 1 1 1 0
0 0 0 0 0 1 0 1 1 1 0 1 0 0 0 
0 0 0 1 1 1 0 1 0 0 0 1 0 1 1 
0 1 0 1 0 0 0 0 0 1 0 1 0 1 0
0 1 0 1 0 1 1 1 1 1 0 0 0 1 0 
0 1 0 1 0 0 0 0 0 0 0 0 0 0 0 
0 1 0 0 0 1 1 1 0 1 1 1 0 1 1
0 1 1 1 1 0 0 1 0 1 0 0 0 1 0 
0 0 0 0 0 0 0 0 0 1 0 1 0 0 0 
