3 6
7 8
6
0 0
13 0
0 14
14 14
3 12
10 4

0 0 0 0 1 0 0 0 0 0 0 0 0 0 1
0 1 0 1 1 1 1 0 1 1 1 1 1 0 0
0 1 0 0 1 0 1 0 1 0 1 0 1 0 1
0 1 1 0 0 0 1 0 1 0 1 0 1 0 1
0 0 0 0 1 0 0 0 0 0 0 0 0 0 0
1 0 1 1 1 1 1 0 1 1 1 0 1 0 1
0 0 0 0 1 1 0 0 0 0 1 0 1 1 0
0 1 0 0 1 0 0 1 1 0 1 0 1 0 0 
0 1 1 0 1 0 1 0 0 0 1 0 1 0 0
0 1 0 0 0 0 1 0 1 0 0 0 0 0 1
0 0 0 0 1 0 0 0 0 0 1 0 1 1 0
1 1 1 0 1 1 0 1 1 1 1 0 0 0 0
0 0 0 0 1 0 0 0 0 0 0 0 1 1 0
0 1 0 1 1 0 1 0 1 1 0 1 1 1 0
0 0 0 0 0 0 1 0 1 0 0 0 0 0 0 