3 5
8 6
6
0 0
11 1
3 13
13 13
6 9
11 9
0 0 0 1 0 0 0 1 0 0 0 1 0 0 0
0 1 0 0 0 1 0 0 0 1 0 0 0 1 0
0 1 1 1 1 1 1 1 0 0 1 0 1 0 1
0 1 0 0 1 0 0 1 0 0 1 0 1 0 0
0 1 0 0 1 0 0 1 0 0 1 0 1 0 0
0 1 0 0 1 0 0 1 0 0 1 0 0 0 0
0 1 0 0 1 0 0 1 0 0 1 0 0 1 0
0 0 0 1 0 0 0 0 1 0 0 0 1 0 0
1 0 0 0 0 0 1 0 1 0 1 0 0 1 0
0 0 1 1 1 1 0 0 1 0 0 0 0 0 1
0 0 1 0 0 1 0 0 1 1 1 0 0 0 0
0 0 1 0 0 1 0 0 1 0 1 0 1 0 0
0 0 1 0 0 1 0 0 1 0 1 0 0 0 0
0 0 0 0 0 0 0 0 0 0 0 0 0 0 0
0 1 0 0 1 0 1 0 0 0 1 0 0 1 0